**********
*P        *
*         *
*         *
*         *
*         *
*         *
*         *
*       G*
**********

